##############
#      A     #
#      @     #
#           o#
##############