##########
#        #
#        #
#        #
#    A   #
# o  @   #
##########
