##########
#    A   #
#        #
#    @   #
#        #
# o      #
##########