################   #######
#              #   #     #
#  $ $ $ $ ### ##### ### ##
# $ $ $ $ $  . #    $  . ##
#  $ $ ### #.#.# ### #.#.###
# $ $ $  . # .  $  . # .   #
## ### #.#.# ### #.#.# ### ##
 #   . # .  $    # .  $ $.$##
 ###.#.# ### # @ # ### #.#.###
  ##$.$ $  . #    $  . # .   #
  ## ### #.#.# ### #.#.# ### ##
   #   . # .  $  . # .  $ $ $ #
   ###.#.# ### #.#.# ### $ $  #
    ## .  $    # .  $ $ $ $ $ #
    ## ### ##### ### $ $ $ $  #
     #     #   #              #
     #######   ################
