  ####   
###  ####
#     @ #
# #  #@ #
# o o#A #
#########
