##########
#o   @  A#
#     ####
#  @    o#
#        #
# o  @   #
##########