     ##### 
     #   ##
     #    #
 ######   #
##     #o #
# @ @ A  ##
# ######o# 
#        # 
########## 
